R 800 500
NO textures32/brick.xpm
SO textures32/metal.xpm
WE textures32/stone.xpm
EA textures32/wood.xpm

S textures32/sprites/pillar.xpm
F 255,0,0
C 138,71,124
        
        1111111111111111111111111
        1000000000110000000000001
        1011000001110000002000001
        100100000000000N000000001
111111111011000001110000000000001
100000000011000001110111111111111
11110111111111011100000010001
11110111111111011101010010001
11000000110101011100000010001
10002000000000001100000010001
10000000000000001101S10010001
11000001110101011111011110001
11110111 1110101 101111010001
11111111 1111111 111111111111
